26,14
~~~~~~~~~~~~~~~~~~~~~~~~~~
~~xxxxxxxxxxxxxxxxxx||~~~~
~~x-----------------GGGG~~
~~x-GGGGGGG-GGGGGGG-----G~
~~x--GGG||G-G|||||G-GGG-G~
~~~|---G||G-F|||||G-GTG-G~
~~~|||-G||G-G|||GGG-GGG-G~
~~~~||-GGGG-G|GGG-------G~
~~~~~|------GGG---GGGGGG~~
~~~~~~xxxxx-----GG|~~~~~~~
~~~~~~~~~~~GGG-G|~~~~||~~~
~~|~~~~~~~~~|G-G~~~~~|T|~~
~~~~~~~~~~~~~GG~~~~~~|||~~
~~~~~~~~~~~~~~~~~~~~~~~~~~
70
90
0
0
