26,14
11111022222111111120111111
11111021112122212120111111
11111021112111211120111111
11111011122121221110111111
11111012121121121210111111
11111012111111111210111111
11111012122141221110111111
11111012111111111210111111
11111012121121121210111111
11111011122121221110111111
11111021112111211110111111
11111021212122211120111111
11111021111111112120111111
11111022222222222120111111
70
90
18,11,0
16,12,1
12,11,2
10,11,3
6,10,4
7,8,5
9,6,6
9,4,7
12,3,8
10,0,9
14,1,10
18,1,11
15,3,12
