26,14
11111110000000000011111111
11111110111121111011111111
11111110122222221011111111
11111110111111121011111111
11111110122111221011111111
11111110112141211011111111
11111110122111221011111111
11111110121121111011111111
11111110121222121011111111
11111110122212221011111111
11111110111111111011111111
11111110000000000011111111
11111111111111111111111111
11111111111111111111111111
0
90
12,7,0
9,9,1
9,4,2
15,6,3
9,7,4
15,2,5
12,1,6
15,9,7
9,2,8
