26,14
00000111111111111100000000
00000122222222222100000000
00000111111111112100000000
00000121222221212100000000
00000121211111212100000000
00000121212221212100000000
00000121212141212100000000
00000121212111212100000000
00000121212222212100000000
00000121111111111100000000
00000121222222222100000000
00000121111111111100000000
00000122222222222100000000
00000111111111111100000000
75
80
11
14,8,2
10,8,5
14,3,10
6,1,20
16,12,21
12,10,30
8,5,31
16,4,32
6,8,45
12,1,46
10,3,60
0
