26,14
00000022222111111120000000
00000021112122212120000000
00000021112111211120000000
00000011122121221110000000
00000012121121121210000000
00000012111111111210000000
00000012122141221110000000
00000012111111111210000000
00000012121121121210000000
00000011122121221110000000
00000021112111211110000000
00000021212122211120000000
00000021111111112120000000
00000022222222222120000000
80
90
18,11,5
16,12,10
12,11,15
10,11,20
6,10,25
7,8,30
9,6,35
9,4,40
12,3,45
10,0,50
14,1,55
18,1,60
15,3,65
