26,14
11110111111111111101111111
11110122222222222101111111
11110111111111112101111111
11110121222221212101111111
11110121211111212101111111
11110121212221212101111111
11110121212141212101111111
11110121212111212101111111
11110121212222212101111111
11110121111111111101111111
11110121222222222101111111
11110121111111111101111111
11110122222222222101111111
11110111111111111101111111
70
90
14,8,0
10,8,1
14,3,2
6,1,3
16,12,4
12,10,5
8,5,6
16,4,7
6,8,8
12,1,9
10,3,10
