26,14
00000000000000000000000000
00000000111121111000000000
00000000122222221000000000
00000000111111121000000000
00000000122111221000000000
00000000112141211000000000
00000000122111221000000000
00000000121121111000000000
00000000121222121000000000
00000000122212221000000000
00000000111111111000000000
00000000000000000000000000
00000000000000000000000000
00000000000000000000000000
70
90
12,7,0
9,9,5
9,4,7
15,6,14
9,7,16
15,2,25
12,1,26
15,9,28
9,2,30
