33,25
fffffffffffffffffffffffffffffffff
fffffffffffffffffffffffffffffffff
ffHHHHHHHHHHHHHHHHHHHHHHHHHHHHHff
ffH---------------------------Hff
ffH-HH-HHHHH-HHHHHHH-HHHHH-HH-Hff
ffH-HH-HHHHH-HHHHHHH-HHHHH-HH-Hff
ffH-HH---------------------HH-Hff
ffH-HH-HH-HHHHH-H-HHHHH-HH-HH-Hff
ffH-HH-HH-HHHHH-H-HHHHH-HH-HH-Hff
ffH----HH-------H-------HH----Hff
ffH-HH-HH-HH-HHHHHHH-HH-HH-HH-Hff
ffH-HH-HH-HH-HH---HH-HH-HH-HH-Hff
ffH-HH----HH----F----HH----HH-Hff
ffH-HH-HH-HH-HH---HH-HH-HH-HH-Hff
ffH-HH-HH-HH-HHHHHHH-HH-HH-HH-Hff
ffH----HH-------H-------HH----Hff
ffH-HH-HH-HHHHH-H-HHHHH-HH-HH-Hff
ffH-HH-HH-HHHHH-H-HHHHH-HH-HH-Hff
ffH-HH---------------------HH-Hff
ffH-HH-HHHHH-HHHHHHH-HHHHH-HH-Hff
ffH-HH-HHHHH-HHHHHHH-HHHHH-HH-Hff
ffH---------------------------Hff
ffHHHHHHHHHHHHHHHHHHHHHHHHHHHHHff
fffffffffffffffffffffffffffffffff
fffffffffffffffffffffffffffffffff
70
70
25
16,7,0
22,7,2
22,12,4
22,17,6
16,17,8
13,19,10
11,20,11
6,22,13
5,18,14
7,15,15
5,12,17
7,9,19
5,6,21
6,2,23
9,4,25
16,4,27
23,4,29
27,2,31
28,6,33
30,9,35
28,12,37
28,18,39
26,22,40
23,20,42
17,22,44
0
