33,25
000000000000000000000000000000000
000000000000000000000000000000000
002222222222222222222222222222200
002111111111111111111111111111200
002122122222122222221222221221200
002122122222122222221222221221200
002122111111111111111111111221200
002122122122222121222221221221200
002122122122222121222221221221200
002111122111111121111111221111200
002122122122122222221221221221200
002122122122122111221221221221200
002122111122111141111221111221200
002122122122122111221221221221200
002122122122122222221221221221200
002111122111111121111111221111200
002122122122222121222221221221200
002122122122222121222221221221200
002122111111111111111111111221200
002122122222122222221222221221200
002122122222122222221222221221200
002111111111111111111111111111200
002222222222222222222222222222200
000000000000000000000000000000000
000000000000000000000000000000000
0
70
16,7,0
22,7,2
22,12,4
22,17,6
16,17,8
13,19,10
11,20,11
6,22,13
5,18,14
7,15,15
5,12,17
7,9,19
5,6,21
6,2,23
9,4,25
16,4,27
23,4,29
27,2,31
28,6,33
30,9,35
28,12,37
28,18,39
26,22,40
23,20,42
17,22,44
