36,26
000021122112221221221222112221200000
000011111111111111111111111221100000
000011122111221121211122111111100000
000021122222221221221222112211200000
000021122222221221221222212221200000
000022111111111111111112211221200000
000022112111211221221111111111100000
000021122211221221221221122222200000
000021122211221221221221122222200000
000021111111111111111111111111200000
000021222112221111111222112211200000
000021222112221121211222112211200000
000011111111111114111111111111100000
000021122122221121211222112211200000
000021122122221111111222112211200000
000021222111111111111111111111200000
000021222211221221221222122221200000
000021122221221221221222122221200000
000011122111111221221111111121100000
000011111111111111111111111121100000
000021122122121221221222122221200000
000021222122121221221222122221200000
000021221111111111111111111111100000
000021111112111211221112112111100000
000021122222221221221222112222200000
000000000000000000000000000000000000
0
90
